temperature: Temperature (°C)
humidity: Humidity (%)
precipitation: Precipitation (mm)
windspeed: Wind Speed (km/h)
lakelevel: Lake Level (m)
groundwater: Groundwater Level (m a.s.l)
ammonium-n dissolved: Ammonium-N dissolved (mg/l)
calcium: Calcium (mg/l)
chloride: Chloride (mg/l)
chlorophyll a: Chlorophyll A (µg/l)
doc: DOC (mg/l)
total-n: Total-N (mg/l)
potassium: Potassium (mg/l)
conductivity: Conductivity (µS/cm)
magnesium: Magnesium (mg/l)
sodium: Sodium (mg/l)
nitrate-n: Nitrate-N (mg/l)
phaephytin: phaephytin (mg/l)
redox potential: Redox Potential (mV)
oxygen content: Oxygen Content (mg/l)
oxygen saturation: Oxygen Saturation (% O2)
silicon dioxide-si: Silicon Dioxide-Si (mg/l)
sulfate: Sulfate (mg/l)
acid capacity (alkalinity): Acid Capacity / Alkalinity (mmol/l)
total phosphorus: Total Phosphorus (mg/l)
ortho-phosphate-p: ortho-Phosphate-P (mg/l)
secchi depth: Secchi Depth (m)
exiguous achnanthes: Exiguous Achnanthes (%)
tiny achnanthes: Tiny Achnanthes (%)
eutrophic achnanthidium: Eutrophic Achnanthidium (%)
very small achnanthidium: Very Small Achnanthidium (%)
achnanthidium straubianum: Achnanthidium Straubianum (%)
sweet flag: Sweet Flag (%)
adlafia bryophila: Adlafia Bryophila (%)
amphora copulata: Amphora Copulata (%)
amphora indistincta: Amphora Indistincta (%)
amphora ovalis: Amphora Ovalis (%)
amphora pediculus: Amphora Pediculus (%)
amphora subatomus: Amphora Subatomus (%)
aneumastus minor: Aneumastus Minor (%)
aneumastus stroesei: Aneumastus Stroesei (%)
anomoeoneis sphaerophora: Anomoeoneis Sphaerophora (%)
caloneis bacillum: Caloneis Bacillum (%)
cavinula scutelloides: Cavinula Scutelloides (%)
hornwort: Hornwort (%)
opposite stonewort: Opposite Stonewort (%)
globular stonewort: Globular Stonewort (%)
cocconeis neodiminuta: Cocconeis Neodiminuta (%)
cocconeis neothumensis: Cocconeis Neothumensis (%)
cocconeis pediculus: Cocconeis Pediculus (%)
cocconeis placentula var. euglypta: Cocconeis Placentula Var. Euglypta (%)
cocconeis placentula var. lineata: Cocconeis Placentula Var. Lineata (%)
cocconeis placentula var. placentula: Cocconeis Placentula Var. Placentula (%)
cocconeis pseudolineata: Cocconeis Pseudolineata (%)
cymbella hustedtii var. hustedtii: Cymbella Hustedtii Var. Hustedtii (%)
canadian waterweed: Canadian Waterweed (%)
nuttall's waterweed: Nuttall's Waterweed (%)
encyonema prostratum: Encyonema Prostratum (%)
encyonopsis krammeri: Encyonopsis Krammeri (%)
encyonopsis minuta: Encyonopsis Minuta (%)
encyonopsis subminuta: Encyonopsis Subminuta (%)
eolimna minima: Eolimna Minima (%)
epithemia adnata: Epithemia Adnata (%)
epithemia sorex: Epithemia Sorex (%)
epithemia turgida var. turgida: Epithemia Turgida Var. Turgida (%)
fallacia subhamulata: Fallacia Subhamulata (%)
willow moss: Willow Moss (%)
fragilaria brevistriata var. brevistriata: Fragilaria Brevistriata Var. Brevistriata (%)
fragilaria capucina var. capucina: Fragilaria Capucina Var. Capucina (%)
fragilaria construens f. construens: Fragilaria Construens F. Construens (%)
fragilaria construens f. venter: Fragilaria Construens F. Venter (%)
fragilaria martyi: Fragilaria Martyi (%)
fragilaria mesolepta: Fragilaria Mesolepta (%)
fragilaria perminuta: Fragilaria Perminuta (%)
fragilaria pinnata var. pinnata: Fragilaria Pinnata Var. Pinnata (%)
geissleria acceptata: Geissleria Acceptata (%)
geissleria cummerowi: Geissleria Cummerowi (%)
gomphonema italicum: Gomphonema Italicum (%)
gomphonema minusculum: Gomphonema Minusculum (%)
gomphonema olivaceoides: Gomphonema Olivaceoides (%)
gomphonema olivaceum var. olivaceum: Gomphonema Olivaceum Var. Olivaceum (%)
gomphonema parvulum var. parvulum f. parvulum: Gomphonema Parvulum Var. Parvulum F. Parvulum (%)
gomphonema pumilum var. pumilum: Gomphonema Pumilum Var. Pumilum (%)
green algae: Green Algae (%)
hippodonta costulata: Hippodonta Costulata (%)
karayevia clevei var. clevei: Karayevia Clevei Var. Clevei (%)
karayevia clevei var. rostrata: Karayevia Clevei Var. Rostratta (%)
karayevia laterostrata: Karayevia Laterostrata (%)
mayamaea atomus var. permitis: Mayamaea Atomus Var. Permitis (%)
eurasian watermilfoil: Eurasian Watermilfoil (%)
spiny naiad: Spiny Naiad (%)
navicula antonii: Navicula Antonii (%)
navicula associata: Navicula Associata (%)
navicula cari: Navicula Cari (%)
navicula cryptofallax: Navicula Cryptofallax (%)
navicula cryptotenella: Navicula Cryptotenella (%)
navicula cryptotenelloides: Navicula Cryptotenelloides (%)
navicula gregaria: Navicula Gregaria (%)
navicula hofmanniae: Navicula Hofmanniae (%)
navicula jakovljevicii: Navicula Jakovljevicii (%)
navicula lacuum: Navicula Lacuum (%)
navicula radiosa var. radiosa: Navicula Radiosa Var. Radiosa (%)
navicula reichardtiana var. reichardtiana: Navicula Reichardtiana Var. Reichardtiana (%)
navicula slesvicensis: Navicula Slesvicensis (%)
navicula subalpina: Navicula Subalpina (%)
navicula tripunctata: Navicula Tripunctata (%)
navicula utermoehlii: Navicula Utermoehlii (%)
navicula veneta: Navicula Veneta (%)
navicula wildii: Navicula Wildii (%)
neidium dubium: Neidium Dubium (%)
dark stonewort: Dark Stonewort (%)
starry stonewort: Starry Stonewort (%)
nitzschia abbreviata: Nitzschia Abbreviata (%)
nitzschia dissipata ssp. dissipata: Nitzschia Dissipata Ssp. Dissipata (%)
nitzschia fonticola var. fonticola: Nitzschia Fonticola Var. Fonticola (%)
nitzschia lacuum: Nitzschia Lacuum (%)
nitzschia oligotraphenta: Nitzschia Oligotraphenta (%)
nitzschia palea var. debilis: Nitzschia Palea Var. Debilis (%)
nitzschia palea var. palea: Nitzschia Palea Var. Palea (%)
pennales: Pennales (%)
common reed: Common Reed (%)
placoneis clementis: Placoneis Clementis (%)
placoneis gastrum: Placoneis Gastrum (%)
placoneis pseudanglica var. pseudanglica: Placoneis Pseudanglica Var. Pseudanglica (%)
planothidium: Planothidium (%)
planothidium delicatulum: Planothidium Delicatulum (%)
planothidium frequentissimum: Planothidium Frequentissimum (%)
planothidium granum: Planothidium Granum (%)
planothidium joursacense: Planothidium Joursacense (%)
planothidium minutissimum: Planothidium Minutissimum (%)
planothidium rostratum: Planothidium Rostratum (%)
platessa conspicua: Platessa Conspicua (%)
shining pondweed: Shining Pondweed (%)
fennel pondweed: Fennel Pondweed (%)
clasping-leaf pondweed: Clasping-Leaf Pondweed (%)
lesser pondweed: Lesser Pondweed (%)
psammothidium bioretii: Psammothidium Bioretii (%)
psammothidium lauenburgianum: Psammothidium Lauenburgianum (%)
fan-leaved water-crowfoot: Fan-Leaved Water-Crowfoot (%)
reimeria sinuata: Reimeria Sinuata (%)
rhoicosphenia abbreviata: Rhoicosphenia Abbreviata (%)
rhopalodia gibba var. gibba: Rhopalodia Gibba Var. Gibba (%)
tabellaria flocculosa var. flocculosa: Tabellaria Flocculosa Var. Flocculosa (%)
narrowleaf cattail: Narrowleaf Cattail (%)